cccccccc***mmm******
**mm*************mm*
*********mm*********
m************mm*****
***mmmm*************
******************mm
***m******m*********
********m*****b***m*
mm**b*****mmmm*****
*****m**************
**g****mm*******g***
**********g****m****
**mmm********m******
***g*****b******g***
******m*********mmm*
************m*******
*mmmm**mmm***mmmmmmm
*********h**********