cccccc**************
******m*****mmm*****
**m****b************
************b***m***
***mmm**************
*m************b*****
***m*****m**********
******************mm
****mm*****g******mm
****b******m****m***
*****mm*************
m********b**********
****g*****mmm***g***
**m*****************
**************mm****
******m****mmmm*****
**mm**mmmmmmm*******
************h*******