ccccccccccccc*****m***m
**mm************mm**
**m**m**********m***
***mm***m****m******
**mmmm**********mmm*
*****mm*************
**mm*b**mm*****mm***
m******m******m*****
****mmm****b*****m**
**m****g****m*g*m***
****m****m*m**mmm***
***g*****mm*******g*
***b***m*****g***mmm
*mm****************m
*******g****mm**g*mm
***mm***mmm****mm***
*mm*m**m*m*mmmmmm***
*****h**************